


1111111111111111111
1111111111111111111
1111111111111111111
111C1111111P1111111
1111111111111111111
1111111111111111111     
111111111E111111111   
1111111111111111111


