


1111111111111111111
11111P1111111111111
1111111111111111111
111111111111C111111
11111111E1111111111
1111111111111111111
1111111111111111111
1111111111111111111




