


1111111111111111111
1111111111111111111
1111111111111111111
111C0000000P1111111
1111001111111111111
11110C0000011111111     
11111011100E0111111   
1111111111111111111


