

11111111
101C1E11
10101011
100PC001
11111111    

